NO ../textur/img2.webp
F 220,100,0

SO ../textur/img1.webp
WE ../textur/img3.webp
EA ../textur/img4.webp

C 275,30,0







        111111111111111  1111111      111
        1000000000110000000000001
        1011000001110000000000001
        1001000000000000000000001
111111111011000001110000000000001
1000000000110000E01110111111111111
1111011111111101110000010001
11110111111111011101010010001
11000000110101011100 000010001
1000000000000111111111111111111111111100011000000     10001
10000000000000001101010010001
11000001110101011111011110N0111
11110111 1110101 101111010001
11111111 11111111111111111 111111111111




























