NO textur/red_wall.xpm




WE textur/wall_1.xpm
SO textur/wall_2.xpm
EA textur/wall.xpm

F 0  ,       32  ,   0
C 120,0,16

        1111111111111111111111111
        1W00000001100000000000001
        1011000001110000000000001
        1001000000000000000000001
111111111011000001110000000000001
10000000011000001110111110111111
11110111111111011100000010001
11110111111111011101010010001
11000000110101011100000000001
10000000000000001100000010001
10000000000000001101010010001
110000011101010111110111100111
11110111 1110101 101111010001
11111111 1111111 111111111111