NO textur/red_wall.xpm
WE textur/wall_1.xpm
SO textur/wall_2.xpm
EA textur/wall.xpm

F 0,32,0
C 120,0,16

1111111111111111111111111
1000000000110000000000001
1011000001110000000000001
1001000000000000000000001
1111111110110000000000001
1000000000110111110111111
11110111111111010000100011111
11110111111111011101010010001
11000000110101011100000000001
10000000000000001100000010001
10000000000000001101010010001
11000001110101011111011110N0111
11110111111101011101111010001
11111111111111111111111111111
