


NO ../textur/img1.xpm
SO ../textur/img2.xpm



WE ../textur/img4.xpm

F 220,100,0


EA ../textur/img3.xpm






C                        216,30,0




        1111111111111111111111111
        100000000110000000000001
1011000001110000000000001
100100000000000000000001
111111D1101 1000001110000000000001    
10000000001100000111011D111111111
1111011D111111011100000010001
1111011111D1111010000000000001101010010001
11000000110101011100000010001    
1000000000000001100000010001
10000000000000001101010010001
11000001D110101011111011110N0111
111101D1 1110101 10111010001
11111111 1111111 111111111111    
