


NO ./textur/red_wall.xpm
SO ./textur/wall_1.xpm



WE ./textur/wall_2.xpm

F 220,100,0


EA ./textur/wall.xpm





C                        216,30,0




1111111111111111111111111
1000000001100000000000011
1011000001110000S00000001
1001000000000000000000011
1111111101110000011100001    
1000000000110000011101111
1111011111111011100000011
1111011111111101000010001
1100000011010101110000001    
1000000000000001100000001
1000000000000000110100001
1100000111010101111100111
1111011111110101110111001
1100000111010101111100111
1111011111101011101110101
1111111111111111111111111    
