


NO ../textur/red_wall.xpm
SO ../textur/wall_1.xpm



WE ../textur/wall_2.xpm

F 220,100,0


EA ../textur/wall.xpm






C                        216,30,0




        1111111111111111111111111
        100000000110000000000001
1011000001110000000000001
100100000000000000000001
1111111101 1000001110000000000001    
10000000001100000111011111111111
1111011D111111011100000010001
11110111111111010000000000001101010010001
11000000110101011100000010001    
1000000000000001100000010001
10000000000000001101010010001
110000011101010111110111100111
11110111 1110101 101111010001
11000001110101011111011110N0111
1111011 1110101 10111010001
11111111 1111111 111111111111    
