


NO ../textur/img1.webp
SO ../textur/img2.webp



WE ../textur/img4.webp

F 220,100,0


EA ../textur/img3.webp






C 225,30,0




        1111111111111111111111111
        100000000W110000000000001
1011000001110000000000001
1001000000000000000000001
11111111101 1000001110000000000001    
100000000011000001110111111111111
11110111111111011100000010001
11110111111111010000000000001101010010001
11000000110101011100000010001    
10000000000000001100000010001
10000000000000001101010010001
11000001110101011111011110N0111
11110111 1110101 101111010001
11111111 1111111 111111111111    